1,1,1,1,1,a,,1,a,,1,a,,1,a,,1,a,,1,a,,1,a,,1,a,,1,a,,1,a,,1,a,,1,a,,1,a,,1,a,,1,a,,1,a,,1,a,,1,a,,1,a,,1,a,,1,a,,1,a,,1,a,,1,a,,1,1,1,1,1
1,1,1,1,1,,,1,,,1,,,1,,,1,,,1,,,1,,,1,,,1,,,1,,,1,,,1,,,1,,,1,,,1,,,1,,,1,,,1,,,1,,,1,,,1,,,1,,,1,,,1,,,1,1,1,1,1
1,1,1,1,1,1,1,1,1,1,1,1,1,1,1,1,1,1,1,1,1,1,1,1,1,1,1,1,1,1,1,1,1,1,1,1,1,1,1,1,1,1,1,1,1,1,1,1,1,1,1,1,1,1,1,1,1,1,1,1,1,1,1,1,1,1,1,1,1,1,1,1,1,1,1,1,1,1,1,1,1
1,1,1,1,1,a,,1,a,,1,a,,1,a,,1,a,,1,a,,1,a,,1,a,,1,a,,1,a,,1,a,,1,a,,1,a,,1,a,,1,a,,1,a,,1,a,,1,a,,1,a,,1,a,,1,a,,1,a,,1,a,,1,a,,1,1,1,1,1
1,1,1,1,1,,,1,,,1,,,1,,,1,,,1,,,1,,,1,,,1,,,1,,,1,,,1,,,1,,,1,,,1,,,1,,,1,,,1,,,1,,,1,,,1,,,1,,,1,,,1,,,1,1,1,1,1
1,1,1,1,1,1,1,1,1,1,1,1,1,1,1,1,1,1,1,1,1,1,1,1,1,1,1,1,1,1,1,1,1,1,1,1,1,1,1,1,1,1,1,1,1,1,1,1,1,1,1,1,1,1,1,1,1,1,1,1,1,1,1,1,1,1,1,1,1,1,1,1,1,1,1,1,1,1,1,1,1
1,1,1,1,1,a,,1,a,,1,a,,1,a,,1,a,,1,a,,1,a,,1,a,,1,a,,1,a,,1,a,,1,a,,1,a,,1,a,,1,a,,1,a,,1,a,,1,a,,1,a,,1,a,,1,a,,1,a,,1,a,,1,a,,1,1,1,1,1
1,1,1,1,1,,,1,,,1,,,1,,,1,,,1,,,1,,,1,,,1,,,1,,,1,,,1,,,1,,,1,,,1,,,1,,,1,,,1,,,1,,,1,,,1,,,1,,,1,,,1,,,1,1,1,1,1
1,1,1,1,1,1,1,1,1,1,1,1,1,1,1,1,1,1,1,1,1,1,1,1,1,1,1,1,1,1,1,1,1,1,1,1,1,1,1,1,1,1,1,1,1,1,1,1,1,1,1,1,1,1,1,1,1,1,1,1,1,1,1,1,1,1,1,1,1,1,1,1,1,1,1,1,1,1,1,1,1
1,1,1,1,1,a,,1,a,,1,a,,1,a,,1,a,,1,a,,1,a,,1,a,,1,a,,1,a,,1,a,,1,a,,1,a,,1,a,,1,a,,1,a,,1,a,,1,a,,1,a,,1,a,,1,a,,1,a,,1,a,,1,a,,1,1,1,1,1
1,1,1,1,1,,,1,,,1,,,1,,,1,,,1,,,1,,,1,,,1,,,1,,,1,,,1,,,1,,,1,,,1,,,1,,,1,,,1,,,1,,,1,,,1,,,1,,,1,,,1,,,1,1,1,1,1
1,1,1,1,1,1,1,1,1,1,1,1,1,1,1,1,1,1,1,1,1,1,1,1,1,1,1,1,1,1,1,1,1,1,1,1,1,1,1,1,1,1,1,1,1,1,1,1,1,1,1,1,1,1,1,1,1,1,1,1,1,1,1,1,1,1,1,1,1,1,1,1,1,1,1,1,1,1,1,1,1
1,1,1,1,1,a,,1,a,,1,a,,1,a,,1,a,,1,a,,1,a,,1,a,,1,a,,1,a,,1,a,,1,a,,1,a,,1,a,,1,a,,1,a,,1,a,,1,a,,1,a,,1,a,,1,a,,1,a,,1,a,,1,a,,1,1,1,1,1
1,1,1,1,1,,,1,,,1,,,1,,,1,,,1,,,1,,,1,,,1,,,1,,,1,,,1,,,1,,,1,,,1,,,1,,,1,,,1,,,1,,,1,,,1,,,1,,,1,,,1,,,1,1,1,1,1
1,1,1,1,1,1,1,1,1,1,1,1,1,1,1,1,1,1,1,1,1,1,1,1,1,1,1,1,1,1,1,1,1,1,1,1,1,1,1,1,1,1,1,1,1,1,1,1,1,1,1,1,1,1,1,1,1,1,1,1,1,1,1,1,1,1,1,1,1,1,1,1,1,1,1,1,1,1,1,1,1
1,1,1,1,1,a,,1,a,,1,a,,1,a,,1,1,1,1,1,1,1,1,1,1,1,1,1,1,1,1,1,1,1,1,1,1,1,1,1,1,1,1,1,1,1,1,1,1,1,1,1,1,1,1,1,1,1,1,1,1,1,1,1,a,,1,a,,1,a,,1,a,,1,1,1,1,1
1,1,1,1,1,,,1,,,1,,,1,,,1,1,2,2,2,2,2,2,2,2,2,2,2,2,1,2,2,2,2,2,2,2,2,2,2,2,2,2,2,2,2,2,2,2,2,2,2,2,2,2,2,2,2,2,2,2,2,1,1,,,1,,,1,,,1,,,1,1,1,1,1
1,1,1,1,1,1,1,1,1,1,1,1,1,1,1,1,1,1,2,2,2,2,2,2,2,2,2,2,2,2,2,2,3,3,4,4,4,2,2,2,2,2,2,2,2,2,2,2,2,2,2,2,2,2,2,2,2,2,2,2,2,2,2,1,1,1,1,1,1,1,1,1,1,1,1,1,1,1,1,1,1
1,1,1,1,1,a,,1,a,,1,a,,1,a,,1,1,2,2,2,2,3,3,3,3,3,3,3,3,3,3,3,3,3,4,4,3,3,3,3,3,3,3,3,3,3,3,3,3,3,4,3,3,3,3,3,3,3,3,4,2,2,1,1,a,,1,a,,1,a,,1,a,,1,1,1,1,1
1,1,1,1,1,,,1,,,1,,,1,,,1,1,2,2,3,3,4,3,3,3,4,4,4,4,5,3,3,4,4,4,4,4,4,4,4,4,4,4,4,4,4,4,4,4,4,4,4,4,4,4,4,4,4,4,5,2,2,1,1,,,1,,,1,,,1,,,1,1,1,1,1
1,1,1,1,1,1,1,1,1,1,1,1,1,1,1,1,1,1,2,2,3,4,3,3,3,4,4,4,4,4,4,3,3,4,4,4,4,4,4,4,4,4,4,4,4,4,4,4,4,4,4,4,4,4,4,4,4,4,4,4,2,2,2,1,1,1,1,1,1,1,1,1,1,1,1,1,1,1,1,1,1
1,1,1,1,1,a,,1,a,,1,a,,1,a,,1,1,2,2,3,3,3,3,3,4,4,5,5,4,4,4,4,4,4,4,4,4,4,4,4,4,4,4,4,4,4,4,4,4,4,4,4,4,4,4,4,4,4,4,4,2,2,1,1,a,,1,a,,1,a,,1,a,,1,1,1,1,1
1,1,1,1,1,,,1,,,1,,,1,,,1,1,2,2,3,4,3,3,3,4,5,5,5,5,5,5,5,5,5,5,4,4,5,5,5,5,5,6,5,5,5,5,5,5,5,5,5,5,5,5,4,4,4,3,3,2,2,1,1,,,1,,,1,,,1,,,1,1,1,1,1
1,1,1,1,1,1,1,1,1,1,1,1,1,1,1,1,1,1,2,2,3,4,4,4,4,4,5,5,5,5,5,5,5,5,5,5,4,4,5,5,5,5,5,5,6,5,5,5,5,5,5,6,5,5,5,5,4,4,4,3,3,2,2,1,1,1,1,1,1,1,1,1,1,1,1,1,1,1,1,1,1
1,1,1,1,1,a,,1,a,,1,a,,1,a,,1,1,2,2,3,3,4,4,4,5,5,5,5,5,5,5,5,5,5,5,5,5,5,5,5,5,5,5,5,5,5,5,5,5,5,5,5,5,5,5,5,4,4,3,3,2,2,1,1,a,,1,a,,1,a,,1,a,,1,1,1,1,1
1,1,1,1,1,,,1,,,1,,,1,,,1,1,2,2,3,3,4,4,5,5,5,5,5,5,5,5,5,5,5,5,5,5,5,5,5,5,5,5,5,5,5,5,5,5,5,5,5,5,5,5,5,4,4,3,3,2,2,1,1,,,1,,,1,,,1,,,1,1,1,1,1
1,1,1,1,1,1,1,1,1,1,1,1,1,1,1,1,1,1,2,2,3,3,4,4,4,5,5,5,5,5,5,5,5,5,5,5,5,5,5,5,5,5,5,5,5,5,5,5,5,5,5,5,5,5,5,5,5,4,4,3,3,2,2,1,1,1,1,1,1,1,1,1,1,1,1,1,1,1,1,1,1
1,1,1,1,1,a,,1,a,,1,a,,1,a,,1,1,2,2,3,3,4,4,4,4,5,5,5,5,5,5,5,5,5,5,5,5,5,5,5,5,5,5,5,5,5,5,5,5,5,5,5,5,5,5,6,4,4,3,3,2,2,1,1,a,,1,a,,1,a,,1,a,,1,1,1,1,1
1,1,1,1,1,,,1,,,1,,,1,,,1,1,2,2,3,3,4,4,4,4,5,5,5,5,6,5,5,5,5,5,5,5,5,5,6,5,5,5,5,5,5,5,5,5,5,5,5,5,5,6,6,4,4,3,3,2,2,1,1,,,1,,,1,,,1,,,1,1,1,1,1
1,1,1,1,1,1,1,1,1,1,1,1,1,1,1,1,1,1,2,2,3,3,4,4,4,5,5,5,5,6,6,6,5,5,5,5,5,5,5,6,6,6,5,5,5,5,5,5,5,5,6,5,5,5,5,5,6,4,4,3,3,2,2,1,1,1,1,1,1,1,1,1,1,1,1,1,1,1,1,1,1
1,1,1,1,1,a,,1,a,,1,a,,1,a,,1,1,2,2,3,3,3,4,4,5,5,5,5,7,7,7,7,7,7,5,5,6,6,6,6,6,6,5,5,5,5,5,6,6,6,5,5,5,5,5,5,4,4,3,3,2,2,1,1,a,,1,a,,1,a,,1,a,,1,1,1,1,1
1,1,1,1,1,,,1,,,1,,,1,,,1,1,2,2,3,3,4,3,4,5,5,5,6,7,8,8,8,9,7,7,7,7,7,7,7,7,7,7,7,7,7,7,7,7,7,6,5,5,5,5,5,4,4,3,3,2,2,1,1,,,1,,,1,,,1,,,1,1,1,1,1
1,1,1,1,1,1,1,1,1,1,1,1,1,1,1,1,1,1,2,2,3,3,4,4,4,5,5,5,6,7,8,10,12,8,8,8,8,8,11,8,8,8,8,8,8,12,8,8,8,7,7,6,6,5,5,5,5,4,4,3,3,2,2,1,1,1,1,1,1,1,1,1,1,1,1,1,1,1,1,1,1
1,1,1,1,1,a,,1,a,,1,a,,1,a,,1,1,2,2,3,3,3,4,4,5,5,6,6,7,8,8,8,8,8,8,8,8,8,8,8,8,8,8,11,8,8,11,8,8,7,6,5,5,5,5,5,5,4,3,3,2,2,1,1,a,,1,a,,1,a,,1,a,,1,1,1,1,1
1,1,1,1,1,,,1,,,1,,,1,,,1,1,2,2,3,3,3,3,4,5,5,5,7,8,8,8,8,11,8,8,8,8,8,8,8,8,8,8,8,8,8,8,9,8,7,6,5,5,5,5,5,5,4,3,3,2,2,1,1,,,1,,,1,,,1,,,1,1,1,1,1
1,1,1,1,1,1,1,1,1,1,1,1,1,1,1,1,1,1,2,2,3,3,4,4,4,5,5,5,7,7,8,8,8,8,8,8,8,8,8,8,8,8,10,8,8,8,8,8,8,8,7,7,5,5,5,5,5,5,4,3,3,2,2,1,1,1,1,1,1,1,1,1,1,1,1,1,1,1,1,1,1
1,1,1,1,1,a,,1,a,,1,a,,1,a,,1,1,2,2,3,3,3,4,4,4,5,5,5,7,9,8,8,8,10,8,8,8,8,8,8,8,8,11,8,8,8,8,8,8,7,7,6,5,5,5,5,5,5,3,3,2,2,1,1,a,,1,a,,1,a,,1,a,,1,1,1,1,1
1,1,1,1,1,,,1,,,1,,,1,,,1,1,2,2,3,3,4,4,4,4,5,5,7,8,7,12,11,8,11,9,8,8,8,8,8,8,8,8,8,8,8,8,12,7,8,6,5,5,5,5,5,6,6,3,3,2,2,1,1,,,1,,,1,,,1,,,1,1,1,1,1
1,1,1,1,1,1,1,1,1,1,1,1,1,1,1,1,1,1,2,2,3,3,4,4,4,5,5,5,5,7,8,8,8,8,8,8,8,11,8,8,8,8,8,8,8,8,10,8,8,8,7,5,5,5,5,5,5,5,6,3,3,2,2,1,1,1,1,1,1,1,1,1,1,1,1,1,1,1,1,1,1
1,1,1,1,1,a,,1,a,,1,a,,1,a,,1,1,2,2,3,3,4,4,4,5,5,5,7,8,7,9,8,8,8,8,8,8,11,8,8,8,8,8,8,8,8,11,8,8,8,7,6,5,5,5,5,5,5,3,3,2,2,1,1,a,,1,a,,1,a,,1,a,,1,1,1,1,1
1,1,1,1,1,,,1,,,1,,,1,,,1,1,2,2,3,3,4,4,4,5,5,5,6,7,7,8,8,8,8,8,8,8,8,8,8,8,8,8,8,8,8,8,8,8,7,6,5,5,5,5,5,5,5,3,3,2,2,1,1,,,1,,,1,,,1,,,1,1,1,1,1
1,1,1,1,1,1,1,1,1,1,1,1,1,1,1,1,1,1,2,2,3,3,4,4,4,5,5,6,5,7,8,8,8,12,8,8,8,8,8,12,12,8,8,8,8,8,8,8,8,9,7,5,5,5,5,5,5,5,5,3,3,2,2,1,1,1,1,1,1,1,1,1,1,1,1,1,1,1,1,1,1
1,1,1,1,1,a,,1,a,,1,a,,1,a,,1,1,2,2,3,3,4,4,4,5,5,5,5,6,7,8,8,9,9,9,7,7,5,7,7,7,7,7,8,8,8,8,9,7,6,5,5,5,5,5,5,5,5,3,3,2,2,1,1,a,,1,a,,1,a,,1,a,,1,1,1,1,1
1,1,1,1,1,,,1,,,1,,,1,,,1,1,2,2,3,3,4,4,4,5,5,5,5,6,6,6,7,7,7,7,5,5,5,7,7,5,5,5,7,9,7,7,7,6,5,5,5,5,5,5,5,5,5,3,3,2,2,1,1,,,1,,,1,,,1,,,1,1,1,1,1
1,1,1,1,1,1,1,1,1,1,1,1,1,1,1,1,1,1,2,2,3,4,4,4,4,6,6,5,4,6,5,5,6,6,5,5,5,5,5,7,5,5,5,5,7,7,7,5,5,5,5,5,5,5,5,5,5,5,5,3,3,2,2,1,1,1,1,1,1,1,1,1,1,1,1,1,1,1,1,1,1
1,1,1,1,1,a,,1,a,,1,a,,1,a,,1,1,2,2,3,3,4,4,4,4,4,4,5,5,5,5,5,5,5,5,5,5,5,6,5,5,5,5,6,6,6,5,5,5,5,5,5,6,6,5,5,5,5,3,3,2,2,1,1,a,,1,a,,1,a,,1,a,,1,1,1,1,1
1,1,1,1,1,,,1,,,1,,,1,,,1,1,2,2,3,3,4,4,4,4,6,4,5,5,5,5,5,5,5,5,5,5,5,5,5,5,5,5,5,6,5,5,5,5,5,5,5,5,6,5,5,5,5,3,3,2,2,1,1,,,1,,,1,,,1,,,1,1,1,1,1
1,1,1,1,1,1,1,1,1,1,1,1,1,1,1,1,1,1,2,2,3,3,4,6,4,6,6,4,5,5,5,5,5,5,5,5,6,5,5,5,5,5,5,5,5,5,6,5,5,5,5,5,5,5,5,5,5,5,5,3,3,2,2,1,1,1,1,1,1,1,1,1,1,1,1,1,1,1,1,1,1
1,1,1,1,1,a,,1,a,,1,a,,1,a,,1,1,2,2,3,3,4,4,4,4,4,4,5,5,5,5,5,5,5,5,5,5,5,5,5,5,5,5,5,5,5,5,5,5,5,5,5,5,5,5,5,5,5,3,3,2,2,1,1,a,,1,a,,1,a,,1,a,,1,1,1,1,1
1,1,1,1,1,,,1,,,1,,,1,,,1,1,2,2,3,3,3,4,4,4,4,5,5,5,5,5,5,5,5,5,5,5,5,5,5,5,5,5,5,5,5,5,5,5,5,5,5,5,5,5,5,5,5,3,3,2,2,1,1,,,1,,,1,,,1,,,1,1,1,1,1
1,1,1,1,1,1,1,1,1,1,1,1,1,1,1,1,1,1,2,2,3,4,4,4,4,4,6,5,5,5,5,5,5,5,5,5,5,5,5,5,5,5,5,5,5,5,5,5,5,5,5,5,5,5,5,5,5,5,5,3,3,2,2,1,1,1,1,1,1,1,1,1,1,1,1,1,1,1,1,1,1
1,1,1,1,1,a,,1,a,,1,a,,1,a,,1,1,2,2,3,3,4,5,5,5,5,5,5,5,5,5,5,5,5,5,5,5,5,5,5,5,5,5,5,5,5,5,5,5,5,5,5,5,5,5,5,5,5,3,3,2,2,1,1,a,,1,a,,1,a,,1,a,,1,1,1,1,1
1,1,1,1,1,,,1,,,1,,,1,,,1,1,2,2,3,4,4,4,5,5,5,5,5,5,5,5,5,5,5,5,5,5,5,5,5,5,5,5,5,5,5,5,5,5,5,5,5,5,5,6,6,5,5,3,3,2,2,1,1,,,1,,,1,,,1,,,1,1,1,1,1
1,1,1,1,1,1,1,1,1,1,1,1,1,1,1,1,1,1,2,3,3,4,5,5,5,5,5,5,5,5,5,5,5,5,5,5,5,5,5,5,5,5,5,5,5,5,5,5,5,5,5,5,5,5,5,5,5,5,5,3,3,2,2,1,1,1,1,1,1,1,1,1,1,1,1,1,1,1,1,1,1
1,1,1,1,1,a,,1,a,,1,a,,1,a,,1,1,2,3,3,4,5,5,5,5,5,5,5,5,5,5,5,5,5,5,5,5,5,5,5,5,5,5,5,5,5,5,6,5,5,5,5,5,5,5,5,5,4,3,3,2,2,1,1,a,,1,a,,1,a,,1,a,,1,1,1,1,1
1,1,1,1,1,,,1,,,1,,,1,,,1,1,2,3,3,4,5,5,5,5,5,5,5,5,5,5,5,5,5,5,5,5,5,6,5,5,5,5,5,5,5,5,5,6,5,5,5,5,5,5,5,4,4,3,3,2,2,1,1,,,1,,,1,,,1,,,1,1,1,1,1
1,1,1,1,1,1,1,1,1,1,1,1,1,1,1,1,1,1,2,3,3,4,5,5,5,5,5,5,5,5,5,5,5,5,5,5,5,5,5,5,5,5,5,5,5,5,5,5,5,5,5,5,5,5,5,5,5,5,4,3,3,2,2,1,1,1,1,1,1,1,1,1,1,1,1,1,1,1,1,1,1
1,1,1,1,1,a,,1,a,,1,a,,1,a,,1,1,2,3,3,4,5,5,5,5,5,5,5,5,5,5,5,5,5,5,5,5,5,5,5,5,5,5,5,5,5,5,5,5,5,5,5,5,5,5,4,4,4,3,3,2,2,1,1,a,,1,a,,1,a,,1,a,,1,1,1,1,1
1,1,1,1,1,,,1,,,1,,,1,,,1,1,2,3,3,4,5,5,5,5,5,5,5,5,5,5,5,5,5,5,5,5,5,5,6,5,5,5,5,5,5,5,5,5,5,5,5,5,5,4,4,5,4,3,3,2,2,1,1,,,1,,,1,,,1,,,1,1,1,1,1
1,1,1,1,1,1,1,1,1,1,1,1,1,1,1,1,1,1,2,3,3,4,5,5,5,5,5,5,5,5,5,6,5,5,5,5,5,5,5,5,5,6,5,5,5,5,5,5,5,5,5,5,5,5,5,5,4,5,4,3,3,2,2,1,1,1,1,1,1,1,1,1,1,1,1,1,1,1,1,1,1
1,1,1,1,1,a,,1,a,,1,a,,1,a,,1,1,2,3,3,4,5,5,5,5,5,5,5,5,6,5,5,5,5,5,5,5,5,5,5,5,5,5,5,5,5,5,5,5,5,5,5,5,5,5,5,4,4,3,3,2,2,1,1,a,,1,a,,1,a,,1,a,,1,1,1,1,1
1,1,1,1,1,,,1,,,1,,,1,,,1,1,2,3,3,4,5,5,5,5,5,5,5,5,5,5,5,5,5,5,5,5,5,5,5,5,5,5,5,5,5,5,5,5,5,5,5,5,5,5,5,4,4,3,3,2,2,1,1,,,1,,,1,,,1,,,1,1,1,1,1
1,1,1,1,1,1,1,1,1,1,1,1,1,1,1,1,1,1,2,3,3,4,5,5,5,5,5,5,5,5,5,5,5,5,5,5,5,5,5,5,5,5,5,5,5,5,5,5,5,5,5,5,5,5,5,5,5,5,4,3,3,2,2,1,1,1,1,1,1,1,1,1,1,1,1,1,1,1,1,1,1
1,1,1,1,1,a,,1,a,,1,a,,1,a,,1,1,2,3,3,4,4,5,5,5,5,5,5,5,5,5,5,5,5,5,5,5,5,5,5,5,5,5,5,5,5,5,5,5,5,5,5,5,5,5,5,5,5,3,3,2,2,1,1,a,,1,a,,1,a,,1,a,,1,1,1,1,1
1,1,1,1,1,,,1,,,1,,,1,,,1,1,2,3,3,4,4,4,5,5,5,5,5,5,5,5,5,5,5,5,5,5,5,5,5,5,5,5,5,5,5,5,5,5,5,5,5,5,5,5,5,5,5,3,3,2,2,1,1,,,1,,,1,,,1,,,1,1,1,1,1
1,1,1,1,1,1,1,1,1,1,1,1,1,1,1,1,1,1,2,3,3,4,4,4,5,5,5,5,5,5,5,5,5,5,5,5,5,5,5,5,5,5,5,5,5,5,5,5,5,5,5,5,5,5,5,5,5,5,5,3,3,2,2,1,1,1,1,1,1,1,1,1,1,1,1,1,1,1,1,1,1
1,1,1,1,1,a,,1,a,,1,a,,1,a,,1,1,2,3,3,4,4,6,4,5,5,5,5,5,5,5,5,5,5,5,5,5,5,5,5,5,5,5,5,5,5,5,5,5,5,5,5,5,5,5,5,5,5,3,3,2,2,1,1,a,,1,a,,1,a,,1,a,,1,1,1,1,1
1,1,1,1,1,,,1,,,1,,,1,,,1,1,2,3,3,4,6,6,4,5,5,5,5,5,5,5,5,5,5,5,5,5,5,5,5,5,5,5,5,5,5,5,5,5,5,6,5,5,5,5,5,5,5,3,3,2,2,1,1,,,1,,,1,,,1,,,1,1,1,1,1
1,1,1,1,1,1,1,1,1,1,1,1,1,1,1,1,1,1,2,3,3,4,4,4,4,5,5,5,5,5,5,5,5,5,5,5,5,5,5,5,5,5,6,5,5,5,5,5,5,5,5,5,6,5,5,5,5,5,5,3,3,2,2,1,1,1,1,1,1,1,1,1,1,1,1,1,1,1,1,1,1
1,1,1,1,1,a,,1,a,,1,a,,1,a,,1,1,2,3,3,4,4,4,5,5,5,5,5,5,5,5,5,5,5,5,5,5,5,5,5,5,5,5,5,5,5,5,5,5,5,5,5,5,5,5,5,5,5,3,3,2,2,1,1,a,,1,a,,1,a,,1,a,,1,1,1,1,1
1,1,1,1,1,,,1,,,1,,,1,,,1,1,2,3,3,4,4,6,5,5,5,5,5,5,5,5,5,5,5,5,5,5,5,5,5,5,5,5,5,5,5,5,5,5,5,5,5,5,5,5,5,5,5,3,3,2,2,1,1,,,1,,,1,,,1,,,1,1,1,1,1
1,1,1,1,1,1,1,1,1,1,1,1,1,1,1,1,1,1,2,3,3,4,4,5,4,4,5,5,5,5,5,5,5,5,5,5,5,5,5,5,5,5,5,5,5,5,5,5,5,5,5,5,5,5,5,5,5,5,5,3,3,2,2,1,1,1,1,1,1,1,1,1,1,1,1,1,1,1,1,1,1
1,1,1,1,1,a,,1,a,,1,a,,1,a,,1,1,2,3,3,4,4,4,4,4,4,5,5,5,5,5,5,5,5,5,5,5,5,5,5,5,5,5,5,5,5,5,5,5,5,5,5,5,5,5,5,5,5,3,3,2,2,1,1,a,,1,a,,1,a,,1,a,,1,1,1,1,1
1,1,1,1,1,,,1,,,1,,,1,,,1,1,2,2,3,3,4,4,4,4,6,4,5,5,5,5,5,5,5,5,5,5,5,5,5,5,5,5,5,5,5,5,5,5,5,5,5,5,6,5,5,5,5,3,3,2,2,1,1,,,1,,,1,,,1,,,1,1,1,1,1
1,1,1,1,1,1,1,1,1,1,1,1,1,1,1,1,1,1,2,2,3,3,4,6,4,6,6,4,5,5,5,5,5,5,5,5,5,5,5,5,5,5,5,5,5,5,5,5,5,5,5,5,5,5,5,5,5,5,5,3,3,2,2,1,1,1,1,1,1,1,1,1,1,1,1,1,1,1,1,1,1
1,1,1,1,1,a,,1,a,,1,a,,1,a,,1,1,2,2,3,3,4,4,4,4,4,4,5,5,5,5,5,5,5,5,5,5,5,5,5,5,5,5,5,5,5,5,5,5,5,5,5,5,5,5,5,5,5,3,3,2,2,1,1,a,,1,a,,1,a,,1,a,,1,1,1,1,1
1,1,1,1,1,,,1,,,1,,,1,,,1,1,2,2,3,3,3,4,4,4,4,5,5,5,5,5,5,5,5,5,5,5,5,5,5,5,5,5,5,5,5,5,5,5,5,5,5,5,5,5,5,5,5,3,3,2,2,1,1,,,1,,,1,,,1,,,1,1,1,1,1
1,1,1,1,1,1,1,1,1,1,1,1,1,1,1,1,1,1,2,2,3,4,4,4,4,4,6,5,5,5,5,5,5,5,5,5,5,5,5,5,5,5,5,5,5,5,5,5,6,5,5,5,5,5,5,5,5,5,5,3,3,2,2,1,1,1,1,1,1,1,1,1,1,1,1,1,1,1,1,1,1
1,1,1,1,1,a,,1,a,,1,a,,1,a,,1,1,2,2,3,3,4,5,5,5,5,5,5,5,5,5,5,5,5,5,5,5,5,6,5,5,5,5,5,5,5,5,5,6,5,5,5,5,5,5,5,5,4,3,3,2,2,1,1,a,,1,a,,1,a,,1,a,,1,1,1,1,1
1,1,1,1,1,,,1,,,1,,,1,,,1,1,2,2,3,4,4,4,5,5,5,5,5,5,5,5,5,5,5,5,5,5,5,5,5,5,5,5,5,5,5,5,5,5,5,5,5,5,5,6,4,4,4,3,3,2,2,1,1,,,1,,,1,,,1,,,1,1,1,1,1
1,1,1,1,1,1,1,1,1,1,1,1,1,1,1,1,1,1,2,3,3,4,5,5,5,5,5,5,5,5,5,5,6,5,5,5,5,5,5,5,5,5,5,5,5,5,5,5,5,5,5,5,5,5,5,4,6,6,4,3,3,2,2,1,1,1,1,1,1,1,1,1,1,1,1,1,1,1,1,1,1
1,1,1,1,1,a,,1,a,,1,a,,1,a,,1,1,2,3,3,4,5,5,5,5,5,5,5,5,5,5,5,5,5,5,5,5,5,5,5,5,5,5,5,5,5,5,5,5,5,5,5,5,4,4,4,4,4,3,3,2,2,1,1,a,,1,a,,1,a,,1,a,,1,1,1,1,1
1,1,1,1,1,,,1,,,1,,,1,,,1,1,2,3,3,4,5,5,5,5,5,5,5,5,5,5,5,5,5,5,5,5,5,5,5,5,5,5,5,5,5,5,5,5,5,5,5,5,4,4,4,6,4,3,3,2,2,1,1,,,1,,,1,,,1,,,1,1,1,1,1
1,1,1,1,1,1,1,1,1,1,1,1,1,1,1,1,1,1,2,3,3,4,5,5,5,5,5,5,5,5,5,5,5,5,5,5,5,5,5,5,5,5,5,5,5,5,5,5,5,5,5,5,5,5,5,4,6,6,4,3,3,2,2,1,1,1,1,1,1,1,1,1,1,1,1,1,1,1,1,1,1
1,1,1,1,1,a,,1,a,,1,a,,1,a,,1,1,2,3,3,4,5,5,5,5,5,5,6,5,5,5,5,5,5,5,5,5,5,5,5,5,5,5,5,5,5,5,5,5,5,5,5,5,5,5,4,4,4,3,3,2,2,1,1,a,,1,a,,1,a,,1,a,,1,1,1,1,1
1,1,1,1,1,,,1,,,1,,,1,,,1,1,2,3,3,4,5,5,5,5,5,5,5,5,5,5,5,5,5,5,5,5,5,5,5,5,5,5,5,5,5,5,5,5,5,5,5,5,5,4,4,4,5,3,3,2,2,1,1,,,1,,,1,,,1,,,1,1,1,1,1
1,1,1,1,1,1,1,1,1,1,1,1,1,1,1,1,1,1,2,3,3,4,5,5,5,5,5,5,5,5,5,5,5,5,5,5,5,5,5,5,5,5,5,5,5,5,5,5,5,5,5,5,5,5,5,4,4,6,5,3,3,2,2,1,1,1,1,1,1,1,1,1,1,1,1,1,1,1,1,1,1
1,1,1,1,1,a,,1,a,,1,a,,1,a,,1,1,2,3,3,4,5,5,5,5,5,5,5,5,5,5,5,5,5,5,5,5,5,5,5,5,5,5,5,5,5,5,5,5,5,5,5,5,5,5,4,4,4,3,3,2,2,1,1,a,,1,a,,1,a,,1,a,,1,1,1,1,1
1,1,1,1,1,,,1,,,1,,,1,,,1,1,2,3,3,4,5,5,5,5,5,5,5,5,5,5,5,5,5,5,5,5,5,5,5,5,5,5,5,5,5,5,5,5,5,5,5,5,5,5,5,4,4,3,3,2,2,1,1,,,1,,,1,,,1,,,1,1,1,1,1
1,1,1,1,1,1,1,1,1,1,1,1,1,1,1,1,1,1,2,3,3,4,4,5,5,5,5,5,5,5,5,5,5,5,5,5,5,5,5,5,5,5,5,5,5,5,5,5,5,5,5,5,5,5,5,5,5,5,4,3,3,2,2,1,1,1,1,1,1,1,1,1,1,1,1,1,1,1,1,1,1
1,1,1,1,1,a,,1,a,,1,a,,1,a,,1,1,2,3,3,4,4,4,5,5,5,5,5,5,5,5,5,5,5,5,5,5,5,5,5,5,5,5,5,5,5,5,5,5,5,5,5,5,5,5,5,5,5,3,3,2,2,1,1,a,,1,a,,1,a,,1,a,,1,1,1,1,1
1,1,1,1,1,,,1,,,1,,,1,,,1,1,2,2,3,3,4,4,4,5,5,5,5,5,5,5,5,5,5,5,5,5,5,5,5,5,5,5,5,6,5,5,5,5,5,5,5,5,6,5,5,5,5,3,3,2,2,1,1,,,1,,,1,,,1,,,1,1,1,1,1
1,1,1,1,1,1,1,1,1,1,1,1,1,1,1,1,1,1,2,2,3,3,4,6,4,5,5,5,5,5,5,5,5,5,5,5,6,5,5,5,5,5,5,5,5,5,6,5,5,5,5,5,5,5,5,5,5,5,5,3,3,2,2,1,1,1,1,1,1,1,1,1,1,1,1,1,1,1,1,1,1
1,1,1,1,1,a,,1,a,,1,a,,1,a,,1,1,2,2,3,3,4,4,4,5,5,5,5,5,5,5,5,5,5,5,5,5,5,5,5,5,5,5,5,5,5,5,5,5,5,5,5,5,5,5,5,5,5,3,3,2,2,1,1,a,,1,a,,1,a,,1,a,,1,1,1,1,1
1,1,1,1,1,,,1,,,1,,,1,,,1,1,2,2,3,3,3,4,5,5,5,5,5,5,5,5,5,5,5,5,5,5,5,5,5,5,5,5,5,5,5,5,5,5,5,5,5,5,5,5,5,5,5,3,3,2,2,1,1,,,1,,,1,,,1,,,1,1,1,1,1
1,1,1,1,1,1,1,1,1,1,1,1,1,1,1,1,1,1,2,2,3,4,4,4,5,5,5,5,5,5,5,5,5,5,5,5,5,5,5,5,5,5,5,5,5,5,5,5,5,5,5,5,5,5,5,5,5,5,5,3,3,2,2,1,1,1,1,1,1,1,1,1,1,1,1,1,1,1,1,1,1
1,1,1,1,1,a,,1,a,,1,a,,1,a,,1,1,2,2,3,3,4,5,5,5,5,5,5,5,5,5,5,5,5,5,5,5,5,5,5,5,5,5,5,5,5,5,5,5,5,5,5,5,5,5,5,5,5,3,3,2,2,1,1,a,,1,a,,1,a,,1,a,,1,1,1,1,1
1,1,1,1,1,,,1,,,1,,,1,,,1,1,2,2,3,4,4,4,5,5,5,5,5,5,5,5,5,5,5,5,5,5,5,5,5,5,5,5,5,5,5,5,5,5,5,5,5,5,5,6,6,5,5,3,3,2,2,1,1,,,1,,,1,,,1,,,1,1,1,1,1
1,1,1,1,1,1,1,1,1,1,1,1,1,1,1,1,1,1,2,3,3,4,5,5,5,5,5,5,5,5,5,5,5,5,5,5,5,4,4,4,4,4,4,5,5,4,4,4,4,5,5,4,5,5,5,5,5,5,5,3,3,2,2,1,1,1,1,1,1,1,1,1,1,1,1,1,1,1,1,1,1
1,1,1,1,1,a,,1,a,,1,a,,1,a,,1,1,3,3,3,4,5,5,5,6,5,5,5,5,5,5,5,5,5,5,5,4,4,4,4,4,4,5,4,4,4,4,4,5,4,4,5,5,5,5,5,5,5,4,4,2,2,1,1,a,,1,a,,1,a,,1,a,,1,1,1,1,1
1,1,1,1,1,,,1,,,1,,,1,,,1,1,3,3,3,4,5,6,5,5,5,5,5,4,4,4,4,5,4,5,5,5,4,5,5,4,4,4,4,5,5,4,4,4,4,5,5,4,4,4,4,5,5,4,4,2,2,1,1,,,1,,,1,,,1,,,1,1,1,1,1
1,1,1,1,1,1,1,1,1,1,1,1,1,1,1,1,1,1,3,3,4,4,5,6,5,5,5,5,4,4,4,4,5,4,5,4,5,4,4,5,4,4,4,4,4,5,4,4,4,4,4,5,4,4,4,4,4,5,4,4,4,2,2,1,1,1,1,1,1,1,1,1,1,1,1,1,1,1,1,1,1
1,1,1,1,1,a,,1,a,,1,a,,1,a,,1,1,3,3,4,5,6,6,3,3,3,3,3,3,3,3,3,4,5,3,3,3,3,4,4,3,3,3,3,3,3,3,3,3,3,3,3,3,3,3,3,3,3,3,3,2,2,1,1,a,,1,a,,1,a,,1,a,,1,1,1,1,1
1,1,1,1,1,,,1,,,1,,,1,,,1,1,2,2,3,5,5,5,3,3,3,3,3,3,3,3,3,3,3,3,3,3,3,3,3,3,3,3,3,3,3,3,3,3,3,3,3,3,3,3,3,3,3,3,3,2,2,1,1,,,1,,,1,,,1,,,1,1,1,1,1
1,1,1,1,1,1,1,1,1,1,1,1,1,1,1,1,1,1,2,3,3,3,3,3,2,2,3,2,2,2,2,2,2,2,2,2,3,3,3,2,2,2,2,2,2,2,2,2,2,2,2,2,2,3,3,3,3,2,2,2,2,2,2,1,1,1,1,1,1,1,1,1,1,1,1,1,1,1,1,1,1
1,1,1,1,1,1,1,1,1,1,1,1,1,1,1,1,1,1,2,2,2,2,2,2,2,2,2,2,2,2,2,2,2,2,2,2,2,2,2,2,2,2,2,2,2,2,2,2,2,2,2,2,2,2,2,2,2,2,2,2,2,2,2,1,1,1,1,1,1,1,1,1,1,1,1,1,1,1,1,1,1